#####################
#@.....#.......g....#
#.#########..######.#
#.................#.#
#.#####.#######.###.#
#.....#.........r...#
#.#.#.#.#.#.#.#.#.#.#
#...!.......^.....$.#
#.#######.#######.#.#
#...................>
#####################
